000000000000000000000000000000000000000000000001110000000000
000000000000000000000000000000000000000000000001110000000000
000000000000000000000000000000000000000000000001110000000000
000000000000000000000000000000000000000000000001110000000000
000000000000000000000000000000000000000000000001110000000000
000000000000000000005555000000000000000000000001110000000000
000000000000000000000000000000000000000000000001110000000000
000000000000001111111111111000000000000000000001110000000000
000000000000001000000000001000000000000000000001110000000000
000000000011001000555550001000000000000000000001110000000000
0000000000000010005555500010000000000B0000000001110000000000
000000011000001000555550001000000000000000000001110000000000
000600000000001000000000001000000000000000000001110000000000
111111222221111111111111111111111111111111111111111111111111
111111111111111111111111111111111111111111111111111111111111
