0000000000000000000000000000000000000000000000000000000000000000000000000000000000000000000000000000
0000000000000000000000000000000000000000000000000000000000000000000000000000000000000000000000000000
0000000000000000000000000000000000000000000000000000000000000000000000000000000000000000000000000000
0000000000000000000000000000000000000000000000L00005550000000000000000000000000000000000000000000000
0000000000000000000000000000000000000000000000000001110000000000000000000000000000000000000000000000
000000000000000000000000000000L000000000000000000000000000000000000000000000000400000000000000000000
0000000000000000000000000000000000000000000001111000000000000000000000005550001110000000000000000000
0000000000000000000000000005000000000000000000000000000000000000000000001110000000000000000000F00000
0000000000000000000000000001101100000000111000L00000000004000000000055000000000000000000000000300000
00000000000000000000000000110001100005000000000000000000111100000000110000000000000000E0000000300000
007000000E0000555000000001100000000001100000000000000000000000000001100000000000000000E0000000300000
000000000E0000000000000011000P00000000000604000555000000000000000011000000040000060000E0000000300000
1111199999999900009999991111111111199999999999999999000000111119999999999999900999999999999999999999
11111DDDDDDDDD2222DDDDDD11111111111DDDDDDDDDDDDDDDDD22222211111DDDDDDDDDDDDDD22DDDDDDDDDDDDDDDDDDDDD
